nästa : siguiente
armar : brazos
promenera : caminar
barn : niño
stad : ciudad
liten : pequeño
fönster : ventanas
genom : través
kan : puede
ute : fuera
inom : dentro
sida : página
lastbil : camión
buss : autobús
byggnad : edificio
har : tienen
gata : calle
varmt : abrigado
verkar : parece
kväll : noche
varje : cada
skydda : protege
skapa : crear
förklara : explicar
diskutera : discutir
ändra : cambiar
vända : volver
anlända : llegar
passa in : caber
gillar (singular) : gusta
gillar (plural) : gustan
gillar : gustar
hata : odiar
respektera : respetar
gå : ir
äta : comer
dricka : beber
sova : dormir
skriva : escribir
läsa : leer
tala : hablar
lyssna : escuchar
se : ver
höra : oír
köpa : comprar
öppna : abrir
förstå : entender
lära : aprender
tro : creer
vänta : esperar
arbeta : trabajar
betala : pagar
hjälpa : ayudar
måla : pintar
simma : nadar
hoppa : saltar
stanna : quedarse
resa : viajar
träffa/hitta : encontrar
fråga : preguntar
svara : responder
säga : decir
använda : usar
börja : empezar
sluta : terminar
välja : elegir
följa : seguir
laga mat : cocinar
ringa : llamar
skicka : enviar
ta : tomar
stänga : cerrar
rensa : limpiar
dammsuga : aspirar
bära : llevar
röra : mover
sälja : vender
känna : sentir
vakna : despertar
leka : jugar
springa : correr
gråta : llorar
skratta : reír
leva : vivir
dö : morir
flytta : mudarse
rita : dibujar
sjunga : cantar
spela : tocar
vila : descansar
andas : respirar
sända : transmitir
träna : entrenar
köra : conducir
stoppa : parar
få : recibir
ge : dar
hålla : mantener
lämna/låta : dejar
visa : mostrar
undervisa : enseñar
boka : reservar
komma : venir
sätta : poner
prata : charlar
behöva : necesitar
önska : desear
förlora : perder
vinna : ganar
lägga : colocar
träffa : conocer
försöka : intentar
påminna : recordar