mat : comida
bröd : pan
ost : queso
mjölk : leche
smör : mantequilla
kött : carne
fisk : pescado
ägg : huevo
frukt : fruta
äpple : manzana
päron : pera
banan : plátano
apelsin : naranja
citron : limón
druva : uva
grönsak : verdura
morot : zanahoria
potatis : patata
tomat : tomate
gurka : pepino
sallad : ensalada
lök : cebolla
vitlök : ajo
svamp : seta
ris : arroz
pasta : pasta
soppa : sopa
sås : salsa
socker : azúcar
salt : sal
peppar : pimienta
olja : aceite
vinäger : vinagre
dryck : bebida
vatten : agua
kaffe : café
te : té
mjöl : harina
kaka : pastel
glass : helado
godis : dulce
choklad : chocolate
